scaffold_14	reverse	GTTAAGGTTAGGGTTTAGGTTAAGGTTAGGGTTAGGGTTAGGGTTAGGGTTAGGGTTAGGGTTAGGGTTAGGGTTAGGGTTAGGGTTAGGGTTAGGGTTA
scaffold_15	reverse	AGCGCACTTCCATTTTTGCCCAGGGGTTAGGGTTAGGGTTAGGGTTAGGGTTAGGGTTAGGGTTAGGGTTAGGGTTAGGGTTAGGGTTAGGGTTAGGGTT
scaffold_60	forward	ACCCTAACCCTAACCCTAACCCTAACCCTAACCCTAACCCTAACCCTAACCCTAACCCTAACCCTAACCCTAACCCTCACCCTCACCCTCACCCTCACCC
scaffold_63	reverse	GGTGAGGGTGAGGGTTAAGGTTAAGGTTAAGGTTAGGGTTAGGGTTAGGGTTAGGGTTAGGGTTAGGGTTAGGGTTAGGGTTAGGGTTAGGGTTAGGGTT
scaffold_70	reverse	TTAAGATATATCATGTAAAACCAAGGGGTTAGGGTTAGGGTTAGGGTTAGGGTTAGGGTTAGGGTTAGGGTTAGGGTTAGGGTTAGGGTTAGGGTTAGGG
scaffold_71	forward	CCTAACCCTAACCCTAACCCTAACCCTAACCCTAACCCTAACCCTAACCCTAACCCTAACCCTAACCCTAACCCTAAGTCTAAGTCTAAGTCTAAGTCTG
scaffold_86	reverse	GGGTTAGGGTTAGGGTTAGGGTTAGGTTAGGGTTAGGGTTAGGGTTAGGGTTAGGGTTAGGGTTAGGGTTAGGGTTAGGGTTAGGGTTAGGGTTAGGGTT
scaffold_87	reverse	ACAGCAGTGTACTGTTAGTTACAGTACAGTGACTCACAAAACTGTCCGGGGAAGTGCAACTTTTGCCTTTAGAGTGCCGTAACTCTCTCTTTTTATATGT
scaffold_91	forward	AACCCTAACCCTAACCCTAACCCTAACCCTAACCCTAACCCTAACCCTAACCCTAACCCTAACCCTAACCCTAAACCTAACCCTTGATTCAATCGCAGCG
scaffold_92	forward	ACCCTAACCCTAACCCTAACCCTAACCCTAACCCTAACCCTAACCCTAACCCTAACCCTAACCCTAACCCTAACCCTTAACCCTACATAGCTAAACAGCT
scaffold_95	forward	CTAACCCTAACCCTAACCCTAACCCTAACCCTAACCCTAACCCTAACCCTAACCCTAACCCTAAACCCTAACCCTAAACCCTAAACCCTAAACCCTAACC
scaffold_100	reverse	TTAGGGTTAGGGTTAGGGTTAGAGTTAGGGTTAGGGTTAGGGTTAGGGTTAGGGTTAGGGTTAGGGTTAGGGTTAGGGTTAGGGTTAGGGTTAGGGTTAG
scaffold_105	forward	CTAACCCTAACCCTAACCCTAACCCTAACCCTAACCCTAACCCTAACCCTAACCCTAACCCTAACCCTAAACCCTAAACCCTAAATCCTCACCCTCACCC
scaffold_108	forward	ATGCTTGTCTTGATTTGGGTAAACGCCGAAGGGGGAAGTTGAGCTAAGCTGGAAAGATACGATATATGTACGCGCTTGGACACCCTAACCCTAACCCTAA
scaffold_109	forward	TAACCCTAACCCTAACCCTAACCCTAACCCTAACCCTAACCCTAACCCTAACCCTAACCCTAAACCCTAAACCCTAACCCTAACCCTAACCCCCTCCCCC
scaffold_113	reverse	GACAAAGGAGATCTTTGCATGAATTAGGGTTAGGGTTAGGGTTAGGGTTAGGGTTAGGGTTAGGGTTAGGGTTAGGGTTAGGGTTAGGGTTAGGGTTAGG
scaffold_115	reverse	TAGAATTAGGGTTAGGGTTAGGGTTAGGGTTTAGGGTTAGGGTTTAGGGTTAGGGTTAGGGTTAGGGTTAGGGTTAGGGTTAGGGTTAGGGTTAGGGTTA
scaffold_125	reverse	GTTAAGGTTAAGGTTAAGGTTAGGGTTAAGGTTAAGGTTAGGGTTAGGGTTAGGGTTAGGGTTAGGGTTAGGGTTAGGGTTAGGGTTAGGGTTAGGGTTA
scaffold_128	reverse	GGGTTTAGGGTTAGGGTTAGGGTTTAGGGTTAGGGTTAGGGTTTAGGGTTAGGGTTAGGGTTAGGGTTAGGGTTAGGGTTAGGGTTAGGGTTAGGGTTAG
scaffold_157	reverse	ATTTGACTGGGGTTGTTGAGAGGAACCCACTACGTGAGTGTGGGTTTGAGAGGTTAGGGTTAGTTTGAGGGTTCCCTCAACTAACCTACAGAGTAAATGT
scaffold_180	reverse	AGGGTTAGGGTTTAGGGTTAGGGTTTAGGGTTTAGGGTTTAGGGTTAGGGTTAGGGTTAGGGTTAGGGTTAGGGTTAGGGTTAGGGTTAGGGTTAGGGTT
scaffold_195	forward	CCTAACCCTAACCCTAACCCTAACCCTAACCCTAACCCTAACCCTAACCCTCACCCTCACCCTCACCCTCACCCTCAACCCTCAACCCTCACCCTCACCC
scaffold_210	reverse	TCTCAACAAAGTTGAGGGAACCCTCAAACGAAGTTTGAGAGGTTGAGGGTTTGTCGGGGTAACCCTCAGCTGCGCTGAGAGGTTCGGGGTTAGGGTTATG
scaffold_221	forward	AACCCTAACCCTAACCCTAACCCTAACCCTAACCCTAACCCTAACCCTAACCCTAACCCTAAACCCTAACCCTAACCTTAACCTTAACCTTAACCTTAAC
scaffold_227	reverse	ATTGGAAGCGGTTAGGGTTAGGGTAGGGTTAGGGTTAGGGTTAGGGTTAGGGTTAGGGTTAGGGTTAGGGTTAGGGTTAGGGTTAGGGTTAGGGTTAGGG
scaffold_236	reverse	CCAATGATATTATCGAACTAATATAGGGTTAGGGTTAGGGTTAGGGTTAGGGTTAGGGTTAGGGTTAGGGTTAGGGTTAGGGTTAGGGTTAGGGTTAGGG

Telomeres found: 26 (10 forward, 16 reverse)
