contig_104	reverse	TTAGGGTTAGGGTTAGGGTGAGGGTGAGGGTTAGGGTTAGGGTTAGGGTTAGGGTTAGGGTTAGGGTTAGGGTTAGGGTTAGGGTTAGGGTTAGGGTTAG
contig_105	reverse	TTAGGGTTAGGGTTAGGGTTAGGGTTAGGGTTAGGGTTAGGGTTAGGGTTAGGGTTAGGGTTAGGGTTAGGGTTAGGGTTAGGGTTAGGGTTAGGGTTAG
contig_109	reverse	GTTAATGTTAATGTTAAGGTTTAAGGTTAAAGGTTAAGGTTAAGGTTAAGGTTAAGGTTAAGGTTAAGGTTAAGGTTAGGGTTAAGGTTAAGGTTAGGGT
contig_145	forward	AACCCTAACCCTAACCCTAATCCTAATCCTAATCCTAATCCTAATCCTAATCCTAATCCTAATCCTAATCCTAATCCTAATCCTAATCCTAATCCTAATC
contig_15	forward	TAACCCTAACCCTAACCCTAACCCTAACCCTAACCCTAACCCTAACCCTAAACCCTAACCCTAACCCTAACCCTAACCCTAACCCTAACCCTAACCCTAA
contig_19	forward	GCGCTTCGACACCCTAACCCTAACTCAAACTCATTGAGGATACAGATAGGAAGACAGGATGTAAGGTTTCTATTTTCTAGGTATTTACAAGCCTATACAA
contig_195	reverse	TTAGGGTTAGGGTTAGGGTTAGGGTTAGGGTTAGGGTTAGGGTTAGGGTTAGGGTTAGGGTTAGGGTTAGGGTTAGGGTTAGGGTTAGGGTTAGGGTTAG
contig_201	reverse	GGTTAGGGTTAGGGTTAGGGTTAGGGTTAGGGTTAGGGTTAGGGTTAGGGTTAGGGTTAGGGTTAGGGTTAGGGTTAGGGTTAGGGTTAGGGTTAGGGTT
contig_202	reverse	GTTAGGGTTTAGGGTTTAGGGTTAGGGTTAGGGTTAGGGTTAGGGTTAGGGTTAGGGTTAGGGTTAGGGTTAGGGTTAGGGTTAGGGTTAGGGTTAGGGT
contig_217	reverse	GGTGAGGGTGAGGGTGAGGGTGAGGGTGAGGGTGAGGGTGAGGGTGAGGGTGAGGGTGAGGGTGAGGGTGAGGGTTAGGGTTAGGGTTAGGGTTAGGGTT
contig_227	forward	CCTAACCCTAACCCTAACCCTAACCCTAACCCTAACCCTAACCCTAACCCTAACCCTAACCCTAACCCTAACCCTAACCCTAACCCTAACCCTAACCCTA
contig_251	reverse	TTTGCATGAATTAGGGTTAGGGTTAGGGTTAGGGTTAGGGTTAGGGTTAGGGTTAGGGTTAGGGTTAGGGTTAGGGTTAGGGTTAGGGTTAGGGTTAGGG
contig_270	forward	CTAACCCTAACCCTAACCCTAACCCTAACCCTAACCTAACCCTAACCCTAACCCTAACCCCTAACCCTAACCCTAACCCTAACCCTAACCCTAACCCTAA
contig_33	reverse	TAGGGTTAGGGTTAGGGTTAGGGTTAGGGTTAGGGTTAGGGTTAGGGTTAGGGTTAGGGTTAGGGTTAGGGTTAGGGTTAGGGTTAGGGTTAGGGTTAGG
contig_40	reverse	GGTTAGGGTTAGGGTTAGGGTTAGGGTTAGGGTTAGGGTTAGGGTTAGGGTTAGGGTTAGGGTTAGGGTTAGGGTTAGGGTTAGGGTTAGGGTTAGGGTT
contig_64	reverse	ACCTAGAAAATAGAAACCTTACATCCTGTCTTCCTATCTGTATCCTCAATGAGTTTGAGTTAGGGTTAGGGTGTCGAAGCGCGTGCATATATCGCATATT
contig_66	reverse	GGGTTTAGGGTTAGGGTTAGGGTTTAGGGTTTAGGGTTTAGGGTTTAGGGTTAGGGTTAGGGTTTAGGGTTAGGGTTAGGGTTAGGGTTAGGGTTAGGGT
contig_67	forward	ACGATATATGCACGCGCTTCGACACCCTAACCCTAACTCAAACTCATTGAGGATACAGATAGGAAGACAGGATGTAAGGTTTCTATTTTCTAGGTATTTA
contig_68	forward	ACGATATATGCACGCGCTTCGACACCCTAACCCTAACTCAAACTCATTGAGGATACAGATAGGAAGACAGGATGTAAGGTTTCTATTTTCTAGGTATTTA
contig_71	reverse	GTTAGGGTTAGGGTTAGGGTTAGGGTTAGGGTTAGGGTTAGGGTTAGGGTTAGGGTTAGGGTTAGGGTTAGGGTTAGGGTTAGGGTTAGGGTTAGGGTTA
contig_72	reverse	TTAGGGTTAGGGTTAGGGTTAGAGTTAGGGTTAGGGTTAGGGTTAGGGTTAGGGTTAGGGTTAGGGTTAGGGTTAGGGTTAGGGTTAGGGTTAGGGTTAG

Telomeres found: 21 (7 forward, 14 reverse)
