scaffold_1	reverse	GGGTGAGGGTGAGGGTTAGGGTGAGGGTTAGGGTTAGGGTTAGGGTTAGGGTTAGGGTTAGGGTTAGGGTTAGGGTTAGGGTTAGGTTAGGGTTAGGGTT
scaffold_2	reverse	CTCTAGCAAAAGATGTATGCTCTCTTAGGGTTAGGGTTAGGGTTAGGGTTAGGGTTAGGGTTAGGGTTAGGGTTAGGGTTAGGGTTAGGGTTAGGGTTAG
scaffold_4	reverse	TAGAATTAGAATTAGAATTAGAATTAGGGTTAGGGTTAGGGTTAGGGTTAGGGTTAGGGTTAGGGTTAGGGTTAGGGTTAGGGTTAGGGTTAGGGTTAGG
scaffold_8	reverse	AGGGTGAGGGTGAGGGTGAGGGTTTAGGGTTAGGGTTAGGGTTAGGGTTAGGGTTAGGGTTAGGGTTAGGGTTAGGGTTAGGGTTAGGGTTAGGGTTAGG
scaffold_12	forward	ACCCTAACCCTAACCCTAACCCTAACCCTAACCCTAACCCTAACCCTAACCCTAACCCTAACCCTAACCCTAACCCTCACTATCACCCTCACCCTCACCC
scaffold_14	reverse	GAGAAGGAGAAGGAGAAGGGTGAGGGTGAGGGTGAGGGTGAGGGTGAGGGTGAGGGTGAGGGTGAGGGTTAGGGTTAGGGTTAGGGTTAGGGTTAGGGTT
scaffold_34	reverse	ATTAGGATTAGGGTTAGGATTAGGGGTTAGGGTTAGGGTTAGGGTTAGGGTTAGGGTTAGGGTTAGGGTTAGGGTTAGGGTTAGGGTTAGGGTTAGGGTT
scaffold_35	reverse	ATGATACAGAAATTTGCGCAAACTTAGGGTTAGGGTTAGGGTTAGGGTTAGGGTTAGGGTTAGGGTTAGGGTTAGGGTTAGGGTTAGGGTTAGGGTTAGG
scaffold_48	reverse	GCAAATAGGCCCTTAAGTCCTAAAGGGTTAGGGTTAGGGTTAGGGTTAGGGTTAGGGTTAGGGTTAGGGTTAGGGTTAGGGTTAGGGTTAGGGTTAGGGT
scaffold_50	forward	TAACCCTAACCCTAACCCTAACCCTAACCCTAACCCTAACCCTAACCCTAACCCTAACCCTAACCCTAACCCTAACCAAATCCAAATCCAAATCCATGGT
scaffold_54	forward	CCCTAACCCTAACCCTAACCCTAACCCTAACCCTAACCCTAACCCTAACCCTAACCCTAACCCTAACCCTAACCCTATACCCTATACCCTATATCCGCTT
scaffold_56	forward	CTAACCCTAACCCTAACCCTAACCCTAACCCTAACCCTAACCCTAACCCTAACCCTAACCCTAACCCTAACCCTAATGCATGCGATCCGCGAAATGCGCG
scaffold_59	reverse	AAACAAAGAGAGTTAAGACCATCAACTTAGGGTTAGGGTTAGGGTTAGGGTTAGGGTTAGGGTTAGGGTTAGGGTTAGGGTTAGGGTTAGGGTTAGGGTT
scaffold_62	reverse	AGGGTTAGGGTTAGGGTTAGGGTTAGGGTTAGGGTTAGGGTTAGGGTTAGGGTTAGGGTTAGGGTTAGGGTTAGGGTTAGGGTTAGGGTTAGGGTTAGGG
scaffold_78	forward	AACCCTAACCCTAACCCTAACCCTAACCCTAACCCTAACCCTAACCCTAACCCTAATCCTAATCCTAATCCTAATCCTAATGCTAATGCTAATGCTAATG
scaffold_81	reverse	AAATGGTTTAAACAATGGAGTGAGCTTGGAGGGTTTAGGTGAGGGTTAGGGTTAGGGTTAGGGTTAGGGTGAGGGTGAGGGTTAGGGTTAGGGTGAGGGT
scaffold_83	forward	CTAACCCTAACCCTAACCCTAACCCTAACCCTAACCCTAACCCTAACCCTAACCCTAACCCTAACCCTAACCCTAACTACTTGTTTTACGAATTCCGATG
scaffold_85	reverse	AGGTAGATCTGCATCGATGGACTTTTAGGGTTAGGGTTAGGGTTAGGGTTAGGGTTAGGGTTAGGGTTAGGGTTAGGGTTAGGGTTAGGGTTAGGGTTAG
scaffold_88	forward	CCTAACCCTAACCCTAACCCTAACCCTAACCCTAACCCTAACCCTAACCCTAACCCTAACCCTAACCCTAACCCTATCACCATCACCCTCTCCCTCTCCC
scaffold_99	forward	TAACCCTAACCCTAACCCTAACCCTAACCCTAACCCTCACCCTAACCCTCACCCTCACCCTCACCCTCACCCTAACCTTAACCCTAGCCCTCAGCCCTCA
scaffold_101	forward	ACCCTAACCCTAACCCTAACCCTAACCCTAACCCTAACCCTAACCCTAACCCTAACCCTAACCCTAACCCTAACCCCAACCCCCAACCCCCCAACCCTCT
scaffold_105	forward	CTAACCCTAACCCTAACCCTAACCCTAACCCTAACCCTAACCCTAACCCTAACCCTAACCCTAACCCTAACCCCTAACCCCTAACCCTAACCCTAACCCT
scaffold_115	reverse	ATAGAACGTTACGCTATTTCAACGGGTTAGGGTTAGGGTTAGGGTTAGGGTTAGGGTTAGGGTTAGGGTTAGGGTTAGGGTTAGGGTTAGGGTTAGGGTT

Telomeres found: 23 (10 forward, 13 reverse)
